####     #######P########################
#                                       #
#                                       #
#       $                               #
#                                       #
        XXX                              
#                                       P
#       $                               #
#                                       #
#                                       #
#                                       #
#                                       #
#                                       #
#                                       #
#                                       #
#####   #####P###########################