#########################################
#                                       #
#                                       #
#       $                               #
#                                       #
#        XXX                            #
#                                       #
#       $                               #
#                                       #
#                                       #
#                                       #
#                                       #
#                                       #
#                                       #
#                                       #
#########################################