####     #######P########
#                       #
#   Z                   #         
#       $               #     
#                       # 
    1   XXX             #                 
#    Z                  #             
#                       #              
#                       #       
#                       # 
#                       #
#                       #
#                       #
#                       #
#####   #####P###########