####     #######P########
#                       #
#                       #         
#       $               #     
#                       # 
        XXX             #                 
#                       #             
#                       #              
#                       #       
#                       # 
#                       #
#                       #
#                       #
#                       #
#####   #####P###########