####     #######P########
#                       #
#                       #         
#       $  $            #     
#                       # 
        XXX             #                 
#                       #             
#                       #              
#                       #       
#                       # 
#                       #
#                       #
#                       #
#                       #
#####   #####P###########